Level 1
22222222222222
11111111111111

Level 2
33333333333333
22222222222222
11111111111111

Level 3
55555555555555
44444444444444
33333333333333
22222222222222
11111111111111

